1111111111111
1P0C00C0C0E11
1111111111111
1000000000011
1111111111111
