1111111111111
10P00000C0001
1111111111101
100C0000E11C1
1C11111111101
1000000C00001
1111111111111