1111111111111
10000000C0001
1E11111111101
110C0000P11C1
11C1111111101
1100000C00001
1111111111111