111111111111111111111
1111P0000000000000111
111111C111C1111C10001
111111111111111111101
111000000000000000001
111C11111111C11111101
11101111011111CCCCC01
111011101111111111C01
11100C1111111111111E1
111111111111111111111
